##########
#        #
#    ### #
#     E# #
# ###### #
#    S   #
##########
